00000000000000000000-
00000000000000000000-
00000111111111000000-
00001111111111100000-
00001111111111100000-
00000191011111100000-
00000000001100000000-
00000000000000000000-
00000000000000000000-
00000000000000000000